gameId,blueWins,blueWardsPlaced,blueWardsDestroyed,blueFirstBlood,blueKills,blueDeaths,blueAssists,blueEliteMonsters,blueDragons,blueHeralds,blueTowersDestroyed,blueTotalGold,blueAvgLevel,blueTotalExperience,blueTotalMinionsKilled,blueTotalJungleMinionsKilled,blueGoldDiff,blueExperienceDiff,blueCSPerMin,blueGoldPerMin,redWardsPlaced,redWardsDestroyed,redFirstBlood,redKills,redDeaths,redAssists,redEliteMonsters,redDragons,redHeralds,redTowersDestroyed,redTotalGold,redAvgLevel,redTotalExperience,redTotalMinionsKilled,redTotalJungleMinionsKilled,redGoldDiff,redExperienceDiff,redCSPerMin,redGoldPerMin
4462298411,1,21,6,1,6,2,7,1,0,1,0,16836,7.2,19773,242,60,2569,2378,24.2,1683.6,41,4,0,2,6,1,1,1,0,0,14267,6.8,17395,228,45,-2569,-2378,22.8,1426.7
4499613300,0,14,0,0,3,7,1,0,0,0,0,14428,6.6,16819,215,52,-1217,-539,21.5,1442.8,62,3,1,7,3,11,1,1,0,0,15645,6.8,17358,216,32,1217,539,21.6,1564.5
4520671984,1,16,6,1,12,6,25,1,1,0,0,19321,7,18437,226,42,2574,359,22.6,1932.1,15,2,0,6,12,9,0,0,0,0,16747,7,18078,228,56,-2574,-359,22.8,1674.7
4450067073,0,46,1,0,4,10,3,0,0,0,0,15400,6.6,16607,188,45,-2552,-2052,18.8,1540,51,2,1,10,4,13,1,1,0,0,17952,6.8,18659,212,50,2552,2052,21.2,1795.2
4524773384,1,18,0,0,7,7,10,1,1,0,0,16585,6.8,16982,191,42,-536,-864,19.1,1658.5,17,1,1,7,7,9,0,0,0,0,17121,6.8,17846,234,52,536,864,23.4,1712.1
4522151939,0,17,7,0,7,7,6,0,0,0,0,16230,6.8,17336,216,40,-4,-139,21.6,1623,14,3,1,7,7,5,0,0,0,0,16234,7,17475,177,63,4,139,17.7,1623.4
4521293545,1,17,1,1,6,2,5,1,0,1,0,17834,7.2,19145,276,44,3797,2242,27.6,1783.4,10,1,0,2,6,3,1,1,0,0,14037,6.8,16903,202,48,-3797,-2242,20.2,1403.7
4498239413,0,15,2,0,4,7,3,1,1,0,0,16028,7.4,19000,249,56,-2863,-875,24.9,1602.8,13,3,1,7,4,6,0,0,0,0,18891,7.4,19875,242,52,2863,875,24.2,1889.1
4459704027,1,18,19,1,5,2,7,1,1,0,0,16858,7.2,18543,251,39,2407,939,25.1,1685.8,43,1,0,2,5,3,0,0,0,0,14451,6.6,17604,221,44,-2407,-939,22.1,1445.1
4484202806,0,12,3,0,4,10,1,0,0,0,0,14816,6.6,16519,218,46,-4490,-3582,21.8,1481.6,15,0,1,10,4,6,2,1,1,1,19306,7.4,20101,247,56,4490,3582,24.7,1930.6
4521182941,1,17,2,0,17,9,19,0,0,0,0,20619,7.4,18696,205,43,2828,1962,20.5,2061.9,17,2,1,9,17,7,1,1,0,0,17791,6.8,16734,198,38,-2828,-1962,19.8,1779.1
4518987840,0,17,0,0,2,9,1,0,0,0,0,13405,6.4,15189,182,43,-5392,-2904,18.2,1340.5,19,2,1,9,2,19,1,1,0,0,18797,6.8,18093,231,54,5392,2904,23.1,1879.7
4454235667,1,19,3,0,9,5,9,1,1,0,0,18449,7.2,19139,257,45,2334,1246,25.7,1844.9,62,3,1,5,9,6,0,0,0,0,16115,6.8,17893,231,48,-2334,-1246,23.1,1611.5
4448427323,0,14,1,1,15,3,5,0,0,0,0,19038,7.2,19801,261,32,4941,4702,26.1,1903.8,17,2,0,3,15,5,0,0,0,0,14097,6.2,15099,190,48,-4941,-4702,19,1409.7
4459609583,1,20,2,0,7,3,9,0,0,0,0,17354,7.4,20449,224,63,2301,3412,22.4,1735.4,10,2,1,3,7,4,0,0,0,0,15053,6.6,17037,240,44,-2301,-3412,24,1505.3
4491653265,0,33,3,0,9,12,10,0,0,0,0,18082,7.2,18637,209,54,24,235,20.9,1808.2,52,4,1,12,9,11,2,1,1,0,18058,7,18402,200,44,-24,-235,20,1805.8
4520047610,1,16,2,0,6,6,7,0,0,0,0,16138,6.8,17204,211,31,-243,418,21.1,1613.8,11,3,1,6,6,13,1,0,1,0,16381,6.6,16786,188,52,243,-418,18.8,1638.1
4509495092,0,17,1,0,1,5,0,1,1,0,0,14004,6.4,16302,217,39,-1113,-1381,21.7,1400.4,10,2,1,5,1,5,0,0,0,0,15117,7,17683,212,32,1113,1381,21.2,1511.7
4520390476,1,11,3,1,8,2,11,1,1,0,0,17794,7,17983,220,56,4793,3669,22,1779.4,12,0,0,2,8,2,0,0,0,0,13001,5.8,14314,217,12,-4793,-3669,21.7,1300.1
4479540109,0,14,3,0,2,7,1,0,0,0,0,15373,7.2,18734,252,68,-1942,140,25.2,1537.3,81,1,1,7,2,10,2,1,1,0,17315,7.2,18594,226,52,1942,-140,22.6,1731.5
4487249336,1,38,0,1,11,6,15,1,1,0,0,19218,7,19389,197,56,3248,2147,19.7,1921.8,16,2,0,6,11,4,0,0,0,0,15970,6.8,17242,205,48,-3248,-2147,20.5,1597
4524524540,0,16,2,0,10,13,12,0,0,0,0,18178,6.8,17540,200,35,-286,-494,20,1817.8,17,4,1,13,10,12,1,1,0,0,18464,6.8,18034,171,40,286,494,17.1,1846.4
4482519172,1,52,4,0,10,4,15,1,1,0,0,18501,7.6,19714,230,64,2907,2700,23,1850.1,12,0,1,4,10,6,0,0,0,0,15594,7,17014,215,55,-2907,-2700,21.5,1559.4
4524619949,0,14,3,0,3,10,4,0,0,0,0,14742,6.6,15941,215,52,-3540,-3279,21.5,1474.2,21,0,1,10,3,13,1,1,0,0,18282,7.2,19220,227,44,3540,3279,22.7,1828.2
4518118181,1,12,2,1,6,7,7,0,0,0,0,16119,6.6,16372,203,51,292,-206,20.3,1611.9,25,1,0,7,6,6,1,1,0,0,15827,6.6,16578,206,36,-292,206,20.6,1582.7
4514643182,0,13,1,0,5,9,7,0,0,0,0,15449,6.6,16663,195,56,-2975,-2542,19.5,1544.9,17,3,1,9,5,15,1,1,0,0,18424,7.2,19205,258,48,2975,2542,25.8,1842.4
4505754774,1,28,6,0,14,6,22,0,0,0,0,19890,6.8,17275,174,46,4401,2185,17.4,1989,16,2,1,6,14,6,1,1,0,0,15489,6.2,15090,204,36,-4401,-2185,20.4,1548.9
4518236753,0,18,1,1,4,12,7,0,0,0,0,15233,6.6,16168,208,39,-3184,-2345,20.8,1523.3,13,3,0,12,4,14,0,0,0,0,18417,7,18513,218,44,3184,2345,21.8,1841.7
4521299727,1,35,3,1,13,5,16,0,0,0,0,19452,7.6,20776,212,59,2593,3690,21.2,1945.2,14,3,0,5,13,7,2,1,1,0,16859,6.8,17086,213,64,-2593,-3690,21.3,1685.9
4485967051,0,15,3,0,2,6,3,0,0,0,0,14602,6.8,17042,208,54,-2185,-2480,20.8,1460.2,13,2,1,6,2,4,1,1,0,0,16787,7.2,19522,232,76,2185,2480,23.2,1678.7
4518366913,1,18,2,1,8,3,6,1,1,0,0,17243,6.8,18171,231,52,2803,1638,23.1,1724.3,15,6,0,3,8,5,0,0,0,0,14440,6.6,16533,186,57,-2803,-1638,18.6,1444
4474674368,0,19,2,0,6,5,7,1,1,0,0,15529,7,17721,204,39,-413,-1004,20.4,1552.9,13,3,1,5,6,2,1,0,1,0,15942,7,18725,237,48,413,1004,23.7,1594.2
4469829210,1,34,1,1,9,4,10,2,1,1,0,18303,7.2,19140,263,58,2642,366,26.3,1830.3,16,0,0,4,9,2,0,0,0,0,15661,7,18774,231,49,-2642,-366,23.1,1566.1
4513293772,0,17,0,1,3,9,2,0,0,0,0,13820,5.8,13497,158,45,-3996,-2986,15.8,1382,90,1,0,9,3,14,1,1,0,0,17816,6.6,16483,190,48,3996,2986,19,1781.6
4521129958,1,13,3,1,6,3,5,0,0,0,0,16097,7,18426,226,51,1212,1738,22.6,1609.7,13,3,0,3,6,1,2,1,1,0,14885,6.6,16688,216,50,-1212,-1738,21.6,1488.5
4492730038,0,19,4,1,3,5,6,0,0,0,0,15834,6.8,18088,228,56,-191,-182,22.8,1583.4,145,5,0,5,3,6,1,1,0,0,16025,7.2,18270,208,52,191,182,20.8,1602.5
4517512393,1,14,4,1,9,8,5,1,1,0,0,15852,6.8,17330,194,35,-1918,-1739,19.4,1585.2,16,3,0,8,9,10,1,0,1,0,17770,7.2,19069,213,66,1918,1739,21.3,1777
4515341076,0,15,5,0,5,8,6,1,1,0,0,15483,6.8,16690,174,54,-1429,-683,17.4,1548.3,25,3,1,8,5,10,0,0,0,0,16912,6.8,17373,225,40,1429,683,22.5,1691.2
4522390017,1,17,4,1,4,3,4,0,0,0,0,15202,6.8,17438,215,53,145,-729,21.5,1520.2,49,2,0,3,4,2,1,0,1,0,15057,6.8,18167,247,60,-145,729,24.7,1505.7
4516238123,0,13,3,1,7,6,8,0,0,0,0,16097,6.6,16760,214,42,853,363,21.4,1609.7,17,0,0,6,7,4,1,1,0,0,15244,6.4,16397,182,46,-853,-363,18.2,1524.4
4513729345,1,16,4,1,2,3,1,0,0,0,0,15572,7.2,19166,242,83,902,860,24.2,1557.2,17,0,0,3,2,4,1,1,0,0,14670,6.8,18306,231,47,-902,-860,23.1,1467
4498278588,0,12,1,0,4,6,0,0,0,0,0,15922,7.2,19022,248,64,-1454,-616,24.8,1592.2,36,3,1,6,4,8,0,0,0,0,17376,7.2,19638,207,68,1454,616,20.7,1737.6
4514527472,1,13,5,0,13,3,11,1,0,1,0,19133,7.4,20110,223,40,4238,3475,22.3,1913.3,14,0,1,3,13,2,1,1,0,0,14895,6.6,16635,168,80,-4238,-3475,16.8,1489.5
4497870757,0,17,2,1,3,11,4,1,1,0,0,14625,6.6,16487,200,48,-2978,-2960,20,1462.5,19,3,0,11,3,12,0,0,0,0,17603,7.4,19447,190,44,2978,2960,19,1760.3
4520645604,1,156,0,1,10,6,15,2,1,1,1,20183,7.6,20663,216,73,3663,2748,21.6,2018.3,14,1,0,6,10,6,0,0,0,0,16520,6.8,17915,192,47,-3663,-2748,19.2,1652
4449694269,0,20,7,0,7,8,6,1,1,0,0,16685,6.8,17591,193,40,-335,-681,19.3,1668.5,29,4,1,8,7,7,1,0,1,0,17020,6.8,18272,228,47,335,681,22.8,1702
4511159553,1,18,2,1,9,5,9,1,0,1,0,18408,7.2,19614,225,56,2969,2575,22.5,1840.8,14,4,0,5,9,3,0,0,0,0,15439,6.6,17039,210,60,-2969,-2575,21,1543.9
4500726742,0,14,6,0,2,8,1,1,0,1,0,13895,6.6,16914,210,44,-2894,-1742,21,1389.5,17,2,1,8,2,9,1,1,0,0,16789,7,18656,208,55,2894,1742,20.8,1678.9
4489481429,1,15,1,1,8,9,9,0,0,0,0,17119,7,18174,209,36,-1362,-863,20.9,1711.9,13,3,0,9,8,9,0,0,0,0,18481,7.4,19037,235,55,1362,863,23.5,1848.1
4490249135,0,15,3,1,6,10,5,0,0,0,0,15164,6.4,16581,190,41,-4055,-2248,19,1516.4,32,1,0,10,6,10,1,0,1,0,19219,7.2,18829,236,58,4055,2248,23.6,1921.9
4503626292,1,15,1,1,14,4,14,0,0,0,0,19600,7.4,20132,218,56,5344,3506,21.8,1960,12,1,0,4,14,1,0,0,0,0,14256,6.8,16626,194,47,-5344,-3506,19.4,1425.6
4449918896,0,13,2,1,10,4,7,0,0,0,0,17498,7.4,19402,224,45,2084,2869,22.4,1749.8,10,2,0,4,10,4,0,0,0,0,15414,6.4,16533,228,36,-2084,-2869,22.8,1541.4
4525060117,1,18,3,1,7,2,5,1,1,0,0,16860,6.8,18168,226,49,2984,1565,22.6,1686,22,3,0,2,7,1,0,0,0,0,13876,6.6,16603,216,40,-2984,-1565,21.6,1387.6
4513005798,0,13,0,0,9,5,7,1,1,0,0,17322,7,18525,255,44,1372,2320,25.5,1732.2,13,1,1,5,9,6,0,0,0,0,15950,6.6,16205,213,52,-1372,-2320,21.3,1595
4524609422,1,16,3,1,3,4,2,2,1,1,0,14501,6.6,16819,201,46,-250,489,20.1,1450.1,15,4,0,4,3,6,0,0,0,0,14751,6.4,16330,212,39,250,-489,21.2,1475.1
4491183408,0,17,0,0,8,10,8,1,0,1,0,18020,7.2,19285,214,63,-533,944,21.4,1802,86,1,1,10,8,14,0,0,0,0,18553,7,18341,198,52,533,-944,19.8,1855.3
4520833786,1,17,1,1,10,6,10,0,0,0,0,18559,7,18239,223,61,2606,964,22.3,1855.9,16,0,0,6,10,6,1,1,0,0,15953,6.8,17275,203,60,-2606,-964,20.3,1595.3
4522622334,0,55,2,0,6,7,8,2,1,1,0,16289,6.8,17723,208,56,-963,-64,20.8,1628.9,14,6,1,7,6,11,0,0,0,0,17252,7,17787,230,56,963,64,23,1725.2
4523122447,1,16,4,1,4,3,3,1,1,0,0,15791,7,17326,224,56,960,-812,22.4,1579.1,16,4,0,3,4,5,0,0,0,0,14831,7,18138,223,49,-960,812,22.3,1483.1
4515668714,0,15,3,1,4,10,6,0,0,0,0,15728,6.8,16927,212,56,-1615,-1585,21.2,1572.8,33,4,0,10,4,12,0,0,0,0,17343,7,18512,205,44,1615,1585,20.5,1734.3
4517860054,1,14,4,1,3,2,3,0,0,0,0,15148,6.6,16687,215,48,-44,-1601,21.5,1514.8,19,5,0,2,3,1,0,0,0,0,15192,7,18288,246,51,44,1601,24.6,1519.2
4515298489,0,18,1,0,2,5,4,2,1,1,0,14414,6.4,16249,215,64,-2363,-2144,21.5,1441.4,13,2,1,5,2,10,0,0,0,0,16777,7.2,18393,233,64,2363,2144,23.3,1677.7
4464319633,1,13,2,1,10,8,14,2,1,1,0,17893,7,17157,206,56,1181,-934,20.6,1789.3,13,2,0,8,10,6,0,0,0,0,16712,7,18091,182,47,-1181,934,18.2,1671.2
4520954808,0,11,3,1,8,8,6,0,0,0,0,16488,7,17386,208,41,-870,-1120,20.8,1648.8,15,0,0,8,8,7,1,1,0,0,17358,7.2,18506,241,48,870,1120,24.1,1735.8
4505648249,1,13,1,1,7,8,12,1,1,0,0,16200,6.6,17810,202,42,-927,-736,20.2,1620,13,3,0,8,7,11,1,0,1,0,17127,7.2,18546,207,57,927,736,20.7,1712.7
4464340157,0,13,0,0,5,12,11,1,1,0,0,14353,6.2,15067,168,48,-4550,-3483,16.8,1435.3,11,1,1,12,5,19,0,0,0,0,18903,7.2,18550,216,39,4550,3483,21.6,1890.3
4510837678,1,81,1,0,5,6,6,0,0,0,0,15719,6.8,17801,202,39,-1121,4,20.2,1571.9,16,4,1,6,5,5,0,0,0,0,16840,7,17797,236,48,1121,-4,23.6,1684
4520734931,0,42,4,0,3,5,4,0,0,0,0,15314,7,18205,233,52,-1659,-1566,23.3,1531.4,18,5,1,5,3,5,0,0,0,0,16973,7.4,19771,253,60,1659,1566,25.3,1697.3
4524109040,1,15,2,1,4,1,4,2,1,1,0,16305,7.2,19758,253,64,1793,929,25.3,1630.5,15,2,0,1,4,1,0,0,0,0,14512,7.2,18829,204,76,-1793,-929,20.4,1451.2
4447699269,0,37,5,0,10,6,18,0,0,0,0,17690,7.2,18278,192,45,1377,2429,19.2,1769,16,1,1,6,10,5,0,0,0,0,16313,6.6,15849,194,42,-1377,-2429,19.4,1631.3
4482075284,1,12,3,1,8,2,8,0,0,0,0,18269,7.6,20290,258,49,3389,3465,25.8,1826.9,15,3,0,2,8,1,0,0,0,0,14880,6.4,16825,239,50,-3389,-3465,23.9,1488
4468173353,0,12,2,0,6,12,6,0,0,0,0,15595,6.4,15756,159,48,-3682,-4566,15.9,1559.5,17,1,1,12,6,13,0,0,0,0,19277,7.6,20322,240,54,3682,4566,24,1927.7
4525152197,1,13,3,0,3,7,3,1,0,1,1,16180,6.8,17570,229,45,-981,264,22.9,1618,12,1,1,7,3,11,1,1,0,0,17161,6.8,17306,230,48,981,-264,23,1716.1
4464085930,0,30,0,1,9,9,9,0,0,0,0,17658,7,17546,214,47,108,-88,21.4,1765.8,16,2,0,9,9,8,1,0,1,0,17550,7,17634,235,36,-108,88,23.5,1755
4524157575,1,15,1,1,6,2,6,2,1,1,0,16998,7.2,18708,236,56,2619,1209,23.6,1699.8,14,0,0,2,6,2,0,0,0,0,14379,7,17499,217,52,-2619,-1209,21.7,1437.9
4450431370,0,14,1,0,7,14,8,0,0,0,0,16336,6.8,16919,190,40,-3908,-2704,19,1633.6,17,2,1,14,7,17,1,1,0,0,20244,7.2,19623,208,66,3908,2704,20.8,2024.4
4521386660,1,15,1,1,4,4,1,0,0,0,0,14881,7,18074,209,45,-856,-563,20.9,1488.1,164,3,0,4,4,1,0,0,0,0,15737,7,18637,236,55,856,563,23.6,1573.7
4468568554,0,13,2,0,7,7,8,0,0,0,0,17148,7,17427,226,52,1084,658,22.6,1714.8,15,3,1,7,7,8,2,1,1,0,16064,6.4,16769,207,40,-1084,-658,20.7,1606.4
4462148925,1,17,2,1,4,3,10,1,1,0,0,15730,7,18484,241,52,739,-270,24.1,1573,16,2,0,3,4,5,0,0,0,0,14991,7,18754,239,59,-739,270,23.9,1499.1
4523634047,0,14,0,0,3,5,4,1,0,1,1,16250,6.6,16288,215,48,154,-979,21.5,1625,13,1,1,5,3,11,1,1,0,0,16096,6.8,17267,230,51,-154,979,23,1609.6
4497724425,1,15,1,1,16,5,14,1,1,0,0,19098,7,18636,203,37,2447,247,20.3,1909.8,11,0,0,5,16,3,0,0,0,0,16651,7,18389,207,63,-2447,-247,20.7,1665.1
4483634862,0,14,1,0,5,12,5,0,0,0,0,15634,6.6,16435,222,40,-3194,-2675,22.2,1563.4,50,2,1,12,5,13,1,0,1,0,18828,7.2,19110,205,52,3194,2675,20.5,1882.8
4523546666,1,16,1,0,5,3,6,0,0,0,0,16169,7.2,18880,235,60,561,740,23.5,1616.9,14,0,1,3,5,3,0,0,0,0,15608,7,18140,235,59,-561,-740,23.5,1560.8
4522858842,0,11,0,0,2,7,0,0,0,0,0,13371,6.4,15621,224,0,-3170,-2591,22.4,1337.1,12,1,1,7,2,6,1,1,0,0,16541,6.8,18212,226,40,3170,2591,22.6,1654.1
4503545828,1,52,3,1,8,7,8,0,0,0,0,18078,7,18614,261,48,1204,306,26.1,1807.8,37,2,0,7,8,7,1,1,0,0,16874,6.8,18308,204,52,-1204,-306,20.4,1687.4
4502931082,0,14,0,0,6,7,5,0,0,0,0,15903,7,18823,205,53,-623,1024,20.5,1590.3,14,1,1,7,6,5,1,1,0,0,16526,7,17799,205,48,623,-1024,20.5,1652.6
4523347600,1,13,2,1,9,5,9,1,1,0,0,16329,6.4,16575,206,36,948,16,20.6,1632.9,18,0,0,5,9,4,0,0,0,0,15381,6.8,16559,173,52,-948,-16,17.3,1538.1
4495147066,0,13,1,0,2,9,2,0,0,0,0,13267,6.2,14831,185,40,-5292,-4922,18.5,1326.7,14,3,1,9,2,12,1,1,0,0,18559,7.2,19753,237,64,5292,4922,23.7,1855.9
4513948107,1,20,3,1,11,6,13,1,1,0,0,18401,7,18465,201,51,1843,1402,20.1,1840.1,16,3,0,6,11,8,0,0,0,0,16558,6.8,17063,212,36,-1843,-1402,21.2,1655.8
4524584974,0,15,2,0,4,11,3,0,0,0,0,14956,6.4,16656,216,49,-3532,-2062,21.6,1495.6,17,2,1,11,4,11,0,0,0,0,18488,7.2,18718,217,56,3532,2062,21.7,1848.8
4468712896,1,23,5,1,7,6,6,1,1,0,0,17743,7.4,19173,255,52,1572,829,25.5,1774.3,16,3,0,6,7,4,0,0,0,0,16171,7,18344,218,47,-1572,-829,21.8,1617.1
4524926639,0,16,3,1,8,6,12,0,0,0,0,16808,6.8,16741,200,44,616,-87,20,1680.8,16,4,0,6,8,8,0,0,0,0,16192,6.6,16828,198,48,-616,87,19.8,1619.2
4523887906,1,13,2,0,8,6,8,1,1,0,0,16888,7,18788,202,56,856,1638,20.2,1688.8,44,1,1,6,8,5,1,0,1,0,16032,6.6,17150,198,52,-856,-1638,19.8,1603.2
4522027915,0,21,0,1,10,5,7,1,0,1,0,17971,7.2,19214,231,44,3146,1518,23.1,1797.1,12,3,0,5,10,2,1,1,0,0,14825,7,17696,181,47,-3146,-1518,18.1,1482.5
4458383359,1,15,3,0,8,8,8,1,1,0,0,17706,6.8,18217,217,60,-492,-173,21.7,1770.6,16,0,1,8,8,11,0,0,0,0,18198,7.2,18390,230,52,492,173,23,1819.8
4517748095,0,14,1,0,5,14,6,2,1,1,0,15015,6.6,16032,167,54,-5065,-3552,16.7,1501.5,16,1,1,14,5,9,0,0,0,0,20080,7.4,19584,224,52,5065,3552,22.4,2008
4515399183,1,17,0,1,6,9,5,2,1,1,0,16149,6.8,16641,199,52,34,-957,19.9,1614.9,34,3,0,9,6,9,0,0,0,0,16115,6.8,17598,184,28,-34,957,18.4,1611.5
4495258112,0,17,2,0,9,10,6,1,1,0,0,16954,6.8,16923,197,49,-1073,210,19.7,1695.4,19,3,1,10,9,16,0,0,0,0,18027,6.6,16713,176,51,1073,-210,17.6,1802.7
4487686105,1,12,4,1,8,4,11,0,0,0,0,16763,7,17757,216,34,147,-712,21.6,1676.3,14,2,0,4,8,8,0,0,0,0,16616,7,18469,240,64,-147,712,24,1661.6
4520518919,0,18,1,0,5,4,5,0,0,0,0,15984,7.2,17527,203,54,193,89,20.3,1598.4,15,3,1,4,5,4,0,0,0,0,15791,6.8,17438,222,50,-193,-89,22.2,1579.1
4433310925,1,16,1,1,5,2,5,0,0,0,0,16747,7.2,19858,250,64,2126,1070,25,1674.7,10,2,0,2,5,1,0,0,0,0,14621,7,18788,227,60,-2126,-1070,22.7,1462.1
4496613517,0,17,4,1,9,10,5,0,0,0,0,17193,7,18326,224,40,-1027,-1434,22.4,1719.3,16,2,0,10,9,6,0,0,0,0,18220,7.6,19760,236,56,1027,1434,23.6,1822
4481135148,1,17,3,1,9,6,8,1,0,1,1,18758,7.2,18617,228,44,2137,490,22.8,1875.8,15,3,0,6,9,6,0,0,0,0,16621,6.8,18127,234,52,-2137,-490,23.4,1662.1
4467944823,0,17,3,1,2,10,0,0,0,0,0,14704,7,17930,227,60,-3517,-1818,22.7,1470.4,11,1,0,10,2,7,1,1,0,0,18221,7.6,19748,235,56,3517,1818,23.5,1822.1
4473770063,1,15,3,0,13,8,13,1,0,1,0,20711,7.6,20463,220,68,3673,1956,22,2071.1,15,2,1,8,13,4,1,1,0,0,17038,7,18507,209,44,-3673,-1956,20.9,1703.8
4497717401,0,14,1,0,5,8,3,0,0,0,0,16367,7.2,18191,254,48,-1204,-717,25.4,1636.7,42,3,1,8,5,8,1,1,0,0,17571,7,18908,218,56,1204,717,21.8,1757.1
4516824896,1,22,2,0,8,4,9,0,0,0,0,16539,7,17585,205,46,1947,1396,20.5,1653.9,38,2,1,4,8,3,0,0,0,0,14592,6.6,16189,196,43,-1947,-1396,19.6,1459.2
4509036476,0,10,3,0,0,5,0,0,0,0,0,12905,6.2,15457,195,44,-3927,-3257,19.5,1290.5,17,3,1,5,0,5,0,0,0,0,16832,7,18714,211,78,3927,3257,21.1,1683.2
4524811313,1,20,2,1,11,9,13,1,0,1,0,19096,7.2,19250,206,55,895,910,20.6,1909.6,18,2,0,9,11,9,0,0,0,0,18201,7,18340,235,49,-895,-910,23.5,1820.1
4524695455,0,37,3,0,3,7,0,0,0,0,0,13967,7,16908,197,48,-2681,-834,19.7,1396.7,13,4,1,7,3,6,1,1,0,0,16648,6.6,17742,193,61,2681,834,19.3,1664.8
4524847047,1,24,1,1,11,4,14,2,1,1,0,17938,6.6,16164,199,48,3413,396,19.9,1793.8,11,2,0,4,11,3,0,0,0,0,14525,6.6,15768,195,34,-3413,-396,19.5,1452.5
4514151915,0,15,3,0,8,6,9,1,1,0,0,16511,7,18106,199,48,300,1722,19.9,1651.1,17,0,1,6,8,7,0,0,0,0,16211,6.6,16384,225,44,-300,-1722,22.5,1621.1
4513553506,1,39,1,1,8,11,8,0,0,0,0,17072,6.8,17724,180,63,-2298,-730,18,1707.2,13,2,0,11,8,5,2,1,1,1,19370,7,18454,242,48,2298,730,24.2,1937
4516562361,0,15,3,0,8,7,8,0,0,0,0,17496,7.4,19884,232,35,4,1213,23.2,1749.6,15,2,1,7,8,8,0,0,0,0,17492,7.2,18671,259,56,-4,-1213,25.9,1749.2
4516387872,1,17,4,1,12,4,18,1,1,0,0,19640,7,18636,216,52,5151,3496,21.6,1964,10,1,0,4,12,5,0,0,0,0,14489,6,15140,175,36,-5151,-3496,17.5,1448.9
4522419408,0,16,4,0,2,2,0,1,0,1,0,13742,6.8,17269,208,52,-2296,-1213,20.8,1374.2,15,2,1,2,2,1,1,1,0,0,16038,6.8,18482,250,52,2296,1213,25,1603.8
4522005554,1,15,1,1,7,5,6,1,1,0,0,16891,7,18224,214,65,-51,373,21.4,1689.1,38,2,0,5,7,8,1,0,1,0,16942,6.8,17851,218,48,51,-373,21.8,1694.2
4488609653,0,15,6,0,9,15,10,0,0,0,0,17793,7,18271,187,58,-1961,-392,18.7,1779.3,21,1,1,15,9,19,1,1,0,0,19754,7,18663,173,36,1961,392,17.3,1975.4
4503361762,1,16,3,1,9,3,6,1,1,0,0,17485,7,18330,234,58,3075,1798,23.4,1748.5,17,2,0,3,9,2,0,0,0,0,14410,6.6,16532,214,27,-3075,-1798,21.4,1441
4523824469,0,42,5,1,5,8,6,0,0,0,0,16178,6.8,17363,221,48,-1320,-687,22.1,1617.8,55,1,0,8,5,10,1,0,1,0,17498,7.2,18050,185,52,1320,687,18.5,1749.8
4513537755,1,11,3,1,8,3,4,1,1,0,0,17499,7.2,19191,231,44,2644,2337,23.1,1749.9,20,0,0,3,8,2,0,0,0,0,14855,6.6,16854,208,39,-2644,-2337,20.8,1485.5
4494820088,0,13,0,1,3,8,2,0,0,0,0,14760,6.4,16005,183,53,-1964,-3710,18.3,1476,21,0,0,8,3,6,1,1,0,0,16724,7.4,19715,200,74,1964,3710,20,1672.4
4504128321,1,15,3,1,10,6,9,0,0,0,0,18288,7.2,19569,245,41,2569,1891,24.5,1828.8,127,4,0,6,10,4,1,0,1,0,15719,6.8,17678,220,41,-2569,-1891,22,1571.9
4419100258,0,15,1,0,3,5,3,0,0,0,0,15820,6.8,17793,220,55,-306,-282,22,1582,17,4,1,5,3,8,2,1,1,0,16126,7,18075,222,52,306,282,22.2,1612.6
4524739692,1,15,3,0,7,6,9,1,1,0,1,18551,7.2,18363,225,61,1850,834,22.5,1855.1,18,1,1,6,7,7,0,0,0,0,16701,7,17529,210,57,-1850,-834,21,1670.1
4519853578,0,12,2,0,5,9,3,1,0,1,0,15173,7,17165,183,59,-2354,-1337,18.3,1517.3,16,3,1,9,5,7,1,1,0,0,17527,7,18502,210,46,2354,1337,21,1752.7
4480057032,1,18,3,1,12,4,16,1,1,0,0,19351,7.4,20590,220,40,3969,3522,22,1935.1,14,2,0,4,12,4,0,0,0,0,15382,6.6,17068,221,48,-3969,-3522,22.1,1538.2
4492130975,0,18,0,0,4,3,5,0,0,0,0,14769,6.8,17725,215,36,-1071,-843,21.5,1476.9,10,2,1,3,4,2,0,0,0,0,15840,7,18568,242,51,1071,843,24.2,1584
4452485048,1,14,2,1,10,4,11,1,1,0,0,18969,7.6,20353,205,63,4139,3424,20.5,1896.9,18,0,0,4,10,2,0,0,0,0,14830,6.8,16929,172,61,-4139,-3424,17.2,1483
4509170584,0,17,4,0,4,3,6,0,0,0,0,14353,6.8,17197,178,48,-1009,-280,17.8,1435.3,17,4,1,3,4,1,1,1,0,0,15362,6.8,17477,222,62,1009,280,22.2,1536.2
4461048637,1,13,2,1,8,1,14,1,1,0,0,17113,7,18837,203,52,3278,2617,20.3,1711.3,13,2,0,1,8,0,0,0,0,0,13835,6.6,16220,194,56,-3278,-2617,19.4,1383.5
4521010137,0,16,4,1,8,5,7,0,0,0,0,17044,6.8,17686,217,46,845,-234,21.7,1704.4,14,1,0,5,8,5,1,1,0,0,16199,6.8,17920,207,60,-845,234,20.7,1619.9
4521897188,1,17,2,1,8,5,4,0,0,0,0,16749,6.8,17788,217,43,1152,400,21.7,1674.9,14,2,0,5,8,7,1,1,0,0,15597,6.6,17388,185,68,-1152,-400,18.5,1559.7
4525088163,0,14,2,0,6,7,8,0,0,0,0,15532,6.8,17908,190,48,-1779,-354,19,1553.2,16,1,1,7,6,4,0,0,0,0,17311,7,18262,242,48,1779,354,24.2,1731.1
4519816980,1,21,3,0,4,2,4,0,0,0,0,16523,7.2,18881,222,60,2592,1348,22.2,1652.3,16,5,1,2,4,2,1,1,0,0,13931,6.6,17533,202,52,-2592,-1348,20.2,1393.1
4511374041,0,15,3,0,7,12,6,2,1,1,0,17347,6.6,18118,222,63,-1305,-1101,22.2,1734.7,19,1,1,12,7,15,0,0,0,0,18652,7.4,19219,218,44,1305,1101,21.8,1865.2
4500094420,1,16,6,0,10,9,7,1,0,1,0,17346,7,18518,214,51,149,1781,21.4,1734.6,45,2,1,9,10,10,0,0,0,0,17197,6.8,16737,205,44,-149,-1781,20.5,1719.7
4522608036,0,22,4,0,7,2,5,0,0,0,0,16696,7.2,18900,225,68,1945,2614,22.5,1669.6,17,4,1,2,7,3,0,0,0,0,14751,6.4,16286,196,52,-1945,-2614,19.6,1475.1
4518291052,1,12,4,0,7,4,12,0,0,0,0,16526,6.6,17213,211,54,562,249,21.1,1652.6,21,3,1,4,7,9,1,1,0,0,15964,6.8,16964,233,48,-562,-249,23.3,1596.4
4489090931,0,15,3,1,5,6,7,0,0,0,0,15684,6.8,17384,170,56,-1434,-1409,17,1568.4,17,4,0,6,5,3,1,0,1,0,17118,7.2,18793,223,52,1434,1409,22.3,1711.8
4457019061,1,17,5,1,7,8,8,0,0,0,0,17363,6.8,17169,188,44,903,1019,18.8,1736.3,25,3,0,8,7,7,1,0,1,0,16460,6.4,16150,205,35,-903,-1019,20.5,1646
4523720139,0,13,2,1,1,1,0,1,0,1,0,14737,7,18532,229,59,92,728,22.9,1473.7,11,2,0,1,1,0,0,0,0,0,14645,6.8,17804,199,59,-92,-728,19.9,1464.5
4521675950,1,14,2,0,10,4,9,1,1,0,0,18779,7.2,19556,252,47,3679,2110,25.2,1877.9,60,0,1,4,10,3,0,0,0,0,15100,6.6,17446,203,56,-3679,-2110,20.3,1510
4450091892,0,18,3,1,11,9,13,1,1,0,0,18715,7,18626,223,52,1326,351,22.3,1871.5,13,3,0,9,11,9,0,0,0,0,17389,7.2,18275,208,50,-1326,-351,20.8,1738.9
4524407688,1,18,1,1,2,1,2,1,1,0,0,15649,7,18530,269,56,1281,1111,26.9,1564.9,13,2,0,1,2,0,0,0,0,0,14368,7,17419,225,62,-1281,-1111,22.5,1436.8
4509298842,0,18,2,0,8,8,12,0,0,0,0,17318,6.6,16336,175,56,-266,-1524,17.5,1731.8,46,1,1,8,8,9,1,1,0,0,17584,6.8,17860,217,51,266,1524,21.7,1758.4
4515997665,1,12,5,1,5,6,7,0,0,0,0,16688,7,18697,247,49,1008,-248,24.7,1668.8,44,3,0,6,5,5,1,1,0,0,15680,7.4,18945,199,51,-1008,248,19.9,1568
4523306081,0,15,3,0,8,12,11,0,0,0,0,17201,7.2,18755,207,30,-1817,-354,20.7,1720.1,55,3,1,12,8,13,1,1,0,0,19018,7.4,19109,201,46,1817,354,20.1,1901.8
4496874191,1,12,3,0,6,7,8,1,1,0,0,15900,6.8,17169,203,52,-689,-1431,20.3,1590,18,2,1,7,6,8,0,0,0,0,16589,7.2,18600,218,56,689,1431,21.8,1658.9
4487913203,0,17,2,1,11,2,9,0,0,0,0,18285,7.2,19465,221,37,4581,3919,22.1,1828.5,20,3,0,2,11,1,0,0,0,0,13704,6.6,15546,175,50,-4581,-3919,17.5,1370.4
4510298547,1,17,1,1,12,4,19,1,1,0,0,18377,6.8,17762,193,50,2963,141,19.3,1837.7,15,2,0,4,12,1,0,0,0,0,15414,7,17621,221,47,-2963,-141,22.1,1541.4
4518483468,0,14,6,1,7,3,11,0,0,0,0,17443,7.4,19184,238,45,2786,881,23.8,1744.3,15,4,0,3,7,2,0,0,0,0,14657,6.8,18303,212,57,-2786,-881,21.2,1465.7
4496714478,1,17,4,0,6,9,4,1,1,0,0,17048,7.2,18842,201,64,-32,848,20.1,1704.8,14,2,1,9,6,9,0,0,0,0,17080,7,17994,197,48,32,-848,19.7,1708
4522025457,0,12,1,1,13,6,14,0,0,0,1,20317,7,18795,199,42,3899,2300,19.9,2031.7,14,2,0,6,13,9,1,1,0,0,16418,6.4,16495,197,56,-3899,-2300,19.7,1641.8
4518592520,1,14,2,1,7,1,4,1,1,0,0,16614,7,18570,221,50,3295,3468,22.1,1661.4,14,2,0,1,7,0,0,0,0,0,13319,6.4,15102,205,50,-3295,-3468,20.5,1331.9
4465268169,0,31,2,1,5,5,6,0,0,0,0,16256,7.2,17524,217,51,329,-994,21.7,1625.6,15,5,0,5,5,5,0,0,0,0,15927,7.2,18518,224,53,-329,994,22.4,1592.7
4509979337,1,14,0,0,4,7,1,0,0,0,0,14924,6.8,17139,207,56,-2611,-1375,20.7,1492.4,54,0,1,7,4,5,1,1,0,1,17535,7,18514,218,65,2611,1375,21.8,1753.5
4421824314,0,41,3,0,10,4,8,1,0,1,0,17724,7.4,19917,210,43,3192,3351,21,1772.4,15,4,1,4,10,2,0,0,0,0,14532,6.6,16566,205,39,-3192,-3351,20.5,1453.2
4450271730,1,14,2,0,5,8,3,1,1,0,0,15069,6.6,16824,198,46,-1974,-589,19.8,1506.9,25,1,1,8,5,12,0,0,0,0,17043,6.8,17413,216,40,1974,589,21.6,1704.3
4519746020,0,17,2,0,3,15,2,1,0,1,0,15320,6.8,16625,176,56,-4348,-4019,17.6,1532,33,5,1,15,3,15,1,1,0,0,19668,7.6,20644,208,48,4348,4019,20.8,1966.8
4496792553,1,16,3,0,8,7,13,0,0,0,0,16366,6.8,17010,196,34,-963,-457,19.6,1636.6,16,2,1,7,8,8,0,0,0,0,17329,7,17467,220,52,963,457,22,1732.9
4477353070,0,18,2,0,4,6,5,1,1,0,0,15785,6.8,17629,210,51,-522,-1014,21,1578.5,17,2,1,6,4,4,0,0,0,0,16307,7,18643,221,52,522,1014,22.1,1630.7
4476840336,1,18,2,1,9,4,13,0,0,0,0,17234,6.6,17496,195,44,2477,1105,19.5,1723.4,16,0,0,4,9,3,0,0,0,0,14757,6.6,16391,194,39,-2477,-1105,19.4,1475.7
4426206807,0,14,3,0,10,7,13,0,0,0,0,17625,7.4,19146,205,39,514,2073,20.5,1762.5,14,5,1,7,10,10,0,0,0,0,17111,6.6,17073,223,36,-514,-2073,22.3,1711.1
4462139682,1,30,3,1,9,5,8,1,1,0,0,17826,7.2,18216,220,54,3074,1273,22,1782.6,16,1,0,5,9,2,0,0,0,0,14752,6.4,16943,205,37,-3074,-1273,20.5,1475.2
4508717967,0,18,2,0,15,6,15,0,0,0,0,19931,7,18115,213,40,4375,3249,21.3,1993.1,17,1,1,6,15,6,0,0,0,0,15556,6.2,14866,169,40,-4375,-3249,16.9,1555.6
4465932394,1,13,4,1,11,10,11,0,0,0,0,18042,6.6,17600,221,46,704,-422,22.1,1804.2,18,4,0,10,11,10,0,0,0,0,17338,7,18022,198,42,-704,422,19.8,1733.8
4450360531,0,15,2,1,14,4,15,1,1,0,0,19331,7,19211,213,46,4289,3990,21.3,1933.1,14,1,0,4,14,7,0,0,0,0,15042,6.4,15221,171,36,-4289,-3990,17.1,1504.2
4474160523,1,17,1,1,8,4,9,2,1,1,0,18293,7.4,19340,228,76,2406,2284,22.8,1829.3,14,3,0,4,8,7,0,0,0,0,15887,6.8,17056,224,52,-2406,-2284,22.4,1588.7
4522281462,0,28,4,0,9,10,10,0,0,0,0,17910,6.8,16867,207,45,88,-589,20.7,1791,42,4,1,10,9,11,1,0,1,0,17822,6.8,17456,197,44,-88,589,19.7,1782.2
4436517463,1,13,0,1,5,4,6,0,0,0,0,15895,7,18344,239,38,42,367,23.9,1589.5,18,5,0,4,5,7,1,1,0,0,15853,6.8,17977,258,48,-42,-367,25.8,1585.3
4492030196,0,19,6,0,5,5,6,0,0,0,0,15943,6.6,17366,229,47,-467,-1361,22.9,1594.3,15,2,1,5,5,5,0,0,0,0,16410,7,18727,235,56,467,1361,23.5,1641
4523793959,1,20,1,1,8,2,16,1,1,0,0,18186,7.4,19555,232,67,3131,2377,23.2,1818.6,14,2,0,2,8,5,0,0,0,0,15055,6.6,17178,231,50,-3131,-2377,23.1,1505.5
4523725496,0,14,3,0,2,12,2,0,0,0,0,14158,6.6,16377,194,41,-5740,-3709,19.4,1415.8,19,1,1,12,2,8,2,1,1,0,19898,7.4,20086,240,57,5740,3709,24,1989.8
4506509560,1,22,3,1,17,1,23,1,1,0,0,20151,7.4,19504,226,38,6783,4718,22.6,2015.1,23,1,0,1,17,2,0,0,0,0,13368,6.2,14786,177,53,-6783,-4718,17.7,1336.8
4440187029,0,86,2,0,2,4,1,0,0,0,0,14291,7,18239,207,65,-2609,-1786,20.7,1429.1,15,4,1,4,2,3,1,1,0,0,16900,7.6,20025,259,76,2609,1786,25.9,1690
4522422661,1,16,3,1,4,6,6,1,1,0,0,16452,7,18564,234,54,271,22,23.4,1645.2,14,1,0,6,4,1,1,0,1,0,16181,7,18542,224,64,-271,-22,22.4,1618.1
4518069601,0,14,2,0,5,6,7,0,0,0,0,15078,6.6,16578,202,28,-1018,-828,20.2,1507.8,15,0,1,6,5,6,1,1,0,0,16096,6.8,17406,222,38,1018,828,22.2,1609.6
4494238237,1,15,3,1,9,6,9,0,0,0,0,18287,7.4,19617,226,44,1863,2270,22.6,1828.7,16,3,0,6,9,6,0,0,0,0,16424,6.8,17347,232,49,-1863,-2270,23.2,1642.4
4494166965,0,18,2,0,10,11,9,1,1,0,0,18445,7,18076,199,50,552,-193,19.9,1844.5,13,3,1,11,10,10,0,0,0,0,17893,7,18269,207,36,-552,193,20.7,1789.3
4522459289,1,13,0,0,8,5,8,0,0,0,0,16982,7.2,19524,218,41,-212,1212,21.8,1698.2,12,2,1,5,8,10,2,1,1,0,17194,7.2,18312,242,59,212,-1212,24.2,1719.4
4518235291,0,14,3,0,6,6,7,1,1,0,0,15814,6.8,17161,205,49,-1530,-922,20.5,1581.4,20,2,1,6,6,6,1,0,1,0,17344,7,18083,252,48,1530,922,25.2,1734.4
4471439169,1,19,2,1,9,4,13,0,0,0,0,18369,7.2,19417,210,56,3269,2404,21,1836.9,17,2,0,4,9,1,1,1,0,0,15100,6.8,17013,213,52,-3269,-2404,21.3,1510
4475880508,0,18,4,0,8,13,4,0,0,0,0,16735,7,17923,202,28,-2187,-2383,20.2,1673.5,49,5,1,13,8,15,1,1,0,0,18922,7.2,20306,208,46,2187,2383,20.8,1892.2
4525020504,1,16,3,1,7,6,7,0,0,0,0,17568,6.8,18166,236,64,1308,544,23.6,1756.8,26,2,0,6,7,6,0,0,0,0,16260,7,17622,207,40,-1308,-544,20.7,1626
4518819945,0,11,1,0,8,13,8,0,0,0,0,15818,6.4,16673,172,28,-4100,-3722,17.2,1581.8,20,2,1,13,8,11,0,0,0,0,19918,7.4,20395,220,59,4100,3722,22,1991.8
4524033878,1,23,3,0,9,10,7,0,0,0,0,18090,6.8,17730,229,36,1106,470,22.9,1809,18,2,1,10,9,12,1,0,1,0,16984,7,17260,204,38,-1106,-470,20.4,1698.4
4523974037,0,17,17,0,6,5,6,0,0,0,0,16999,7.2,18578,232,59,389,-279,23.2,1699.9,46,3,1,5,6,6,2,1,1,0,16610,7.2,18857,216,64,-389,279,21.6,1661
4523634644,1,17,2,1,7,4,8,2,1,1,1,18858,7.2,19023,237,66,4338,4607,23.7,1885.8,17,3,0,4,7,11,0,0,0,0,14520,6.2,14416,166,42,-4338,-4607,16.6,1452
4448510561,0,16,3,0,5,10,5,0,0,0,0,15867,6.8,17737,227,47,-1806,-1253,22.7,1586.7,19,1,1,10,5,9,0,0,0,0,17673,7.2,18990,200,44,1806,1253,20,1767.3
4462515361,1,16,1,0,7,5,7,1,1,0,0,16346,6.8,17401,227,52,-90,102,22.7,1634.6,14,2,1,5,7,5,0,0,0,0,16436,7,17299,234,40,90,-102,23.4,1643.6
4523100302,0,17,4,0,1,4,1,0,0,0,0,14305,6.8,17810,251,44,-2889,-2106,25.1,1430.5,19,6,1,4,1,5,1,1,0,0,17194,7.2,19916,282,56,2889,2106,28.2,1719.4
4458124147,1,12,3,0,12,6,16,0,0,0,0,18669,7.2,19226,213,39,1788,761,21.3,1866.9,40,3,1,6,12,7,1,1,0,0,16881,7,18465,208,55,-1788,-761,20.8,1688.1
4520794525,0,44,4,0,6,8,7,0,0,0,0,16295,6.8,17588,222,47,-1271,-364,22.2,1629.5,11,4,1,8,6,10,1,1,0,0,17566,6.8,17952,219,47,1271,364,21.9,1756.6
4467276496,1,36,1,1,5,5,8,0,0,0,0,16192,6.8,18197,209,60,1056,-182,20.9,1619.2,11,1,0,5,5,4,1,1,0,0,15136,7,18379,185,46,-1056,182,18.5,1513.6
4496084500,0,37,2,0,3,9,5,0,0,0,0,14735,6.4,16488,219,38,-2932,-2063,21.9,1473.5,13,2,1,9,3,5,0,0,0,0,17667,7.2,18551,223,44,2932,2063,22.3,1766.7
4524898473,1,13,3,0,8,13,8,1,0,1,1,18954,6.8,17795,228,46,-664,-549,22.8,1895.4,14,3,1,13,8,13,1,1,0,1,19618,7,18344,182,57,664,549,18.2,1961.8
4431984647,0,16,0,0,1,16,1,1,1,0,0,12798,5.8,13908,179,36,-7868,-5339,17.9,1279.8,13,2,1,16,1,16,0,0,0,1,20666,7.2,19247,223,44,7868,5339,22.3,2066.6
4514841518,1,14,1,0,5,6,4,0,0,0,0,15195,7.2,17896,196,43,-1573,-1171,19.6,1519.5,12,1,1,6,5,7,1,1,0,0,16768,7,19067,202,71,1573,1171,20.2,1676.8
4523404068,0,12,1,0,6,7,6,0,0,0,0,16120,7,18149,215,51,-732,750,21.5,1612,17,0,1,7,6,7,1,1,0,0,16852,7,17399,205,56,732,-750,20.5,1685.2
4473962566,1,17,2,0,9,7,10,1,1,0,0,17205,7,18124,218,40,721,2077,21.8,1720.5,16,1,1,7,9,11,0,0,0,0,16484,6.4,16047,212,39,-721,-2077,21.2,1648.4
4443526032,0,35,4,0,4,7,6,0,0,0,0,15902,6.8,17995,241,48,-1190,-66,24.1,1590.2,27,6,1,7,4,14,1,1,0,0,17092,6.8,18061,241,57,1190,66,24.1,1709.2
4517859003,1,17,2,0,6,7,6,0,0,0,0,15615,7,17928,201,49,-1193,-819,20.1,1561.5,17,3,1,7,6,10,0,0,0,0,16808,7,18747,229,36,1193,819,22.9,1680.8
4519045200,0,13,2,0,7,7,6,0,0,0,0,17064,7,18061,236,48,134,-396,23.6,1706.4,15,2,1,7,7,8,1,1,0,0,16930,7,18457,210,59,-134,396,21,1693
4523090796,1,18,3,1,13,3,13,2,1,1,1,19807,6.8,17943,220,36,5227,2051,22,1980.7,47,7,0,3,13,1,0,0,0,0,14580,6.6,15892,210,47,-5227,-2051,21,1458
4491049455,0,16,4,0,5,11,6,0,0,0,0,15424,6.6,16080,208,45,-3692,-3112,20.8,1542.4,14,4,1,11,5,16,2,1,1,0,19116,7.2,19192,195,55,3692,3112,19.5,1911.6
4512968570,1,18,5,1,4,2,5,1,1,0,0,15704,6.8,18292,236,58,1012,519,23.6,1570.4,18,6,0,2,4,0,0,0,0,0,14692,7,17773,234,63,-1012,-519,23.4,1469.2
4517857557,0,14,2,0,4,5,7,1,1,0,0,15786,6.8,17823,207,54,-92,-1170,20.7,1578.6,15,2,1,5,4,3,0,0,0,0,15878,7.4,18993,215,50,92,1170,21.5,1587.8
4517995978,1,16,2,1,4,4,5,1,0,1,1,17073,6.8,17021,221,50,2002,388,22.1,1707.3,14,4,0,4,4,7,0,0,0,0,15071,6.4,16633,203,51,-2002,-388,20.3,1507.1
4452273327,0,48,5,1,4,3,6,0,0,0,0,16596,7,18596,252,64,539,818,25.2,1659.6,19,8,0,3,4,2,1,1,0,0,16057,6.6,17778,236,51,-539,-818,23.6,1605.7
4458685012,1,15,3,1,9,3,11,0,0,0,0,18584,7,18383,203,70,3093,1285,20.3,1858.4,17,2,0,3,9,5,0,0,0,0,15491,6.8,17098,212,41,-3093,-1285,21.2,1549.1
4516355012,0,14,1,1,8,12,5,1,0,1,0,16093,7,16927,154,53,-3195,-953,15.4,1609.3,12,2,0,12,8,13,0,0,0,0,19288,6.8,17880,213,46,3195,953,21.3,1928.8
4447096755,1,22,4,1,6,4,5,2,1,1,0,16697,7.2,19170,236,59,852,1553,23.6,1669.7,17,3,0,4,6,7,0,0,0,0,15845,7,17617,214,51,-852,-1553,21.4,1584.5
4509524180,0,17,3,1,5,7,9,1,1,0,0,15288,6.6,16534,206,57,-861,131,20.6,1528.8,25,3,0,7,5,13,0,0,0,0,16149,6.6,16403,200,34,861,-131,20,1614.9
4470320666,1,48,0,0,10,4,10,2,1,1,0,17973,7.2,20040,196,64,2507,3196,19.6,1797.3,17,1,1,4,10,5,0,0,0,0,15466,6.6,16844,209,48,-2507,-3196,20.9,1546.6
4448123749,0,14,1,0,1,11,0,0,0,0,0,13447,6.4,16199,201,51,-5698,-3675,20.1,1344.7,17,4,1,11,1,12,2,1,1,0,19145,7.2,19874,240,44,5698,3675,24,1914.5
4499907399,1,20,5,0,5,2,6,0,0,0,0,16029,6.8,17493,234,47,1756,1920,23.4,1602.9,16,2,1,2,5,3,0,0,0,0,14273,6.2,15573,199,49,-1756,-1920,19.9,1427.3
4516721414,0,18,4,1,8,8,8,1,1,0,0,16453,6.8,17231,206,40,-569,-213,20.6,1645.3,21,2,0,8,8,10,1,0,1,0,17022,7,17444,199,43,569,213,19.9,1702.2
4523305960,1,17,0,0,4,2,4,2,1,1,0,15752,7.2,19171,231,64,1064,2471,23.1,1575.2,54,2,1,2,4,4,0,0,0,0,14688,6.6,16700,235,44,-1064,-2471,23.5,1468.8
4503391789,0,14,3,0,2,7,1,1,1,0,0,13701,6.6,15431,183,59,-4095,-3017,18.3,1370.1,20,3,1,7,2,6,0,0,0,0,17796,7.2,18448,255,36,4095,3017,25.5,1779.6
4501476679,1,14,2,1,5,3,3,1,1,0,0,15930,7.2,18669,234,44,1713,2145,23.4,1593,17,1,0,3,5,3,0,0,0,0,14217,6.4,16524,188,44,-1713,-2145,18.8,1421.7
4437730015,0,17,3,1,6,5,7,0,0,0,0,16762,7,18180,242,44,482,166,24.2,1676.2,18,2,0,5,6,8,0,0,0,0,16280,6.8,18014,231,48,-482,-166,23.1,1628
4451011365,1,17,1,0,8,4,7,1,1,0,0,17127,6.8,18148,201,48,2294,1383,20.1,1712.7,15,2,1,4,8,2,0,0,0,0,14833,6.4,16765,183,67,-2294,-1383,18.3,1483.3
4490472819,0,15,2,1,8,8,5,0,0,0,0,16795,6.8,18159,235,48,-507,-790,23.5,1679.5,17,2,0,8,8,9,1,0,1,0,17302,7.2,18949,203,56,507,790,20.3,1730.2
4513611157,1,18,4,0,11,6,13,0,0,0,0,18748,7,19116,243,40,2520,2092,24.3,1874.8,53,4,1,6,11,5,0,0,0,0,16228,6.8,17024,224,40,-2520,-2092,22.4,1622.8
4524386145,0,11,2,0,4,12,1,0,0,0,0,14464,6.2,15227,164,58,-4820,-2651,16.4,1446.4,15,0,1,12,4,9,0,0,0,1,19284,7,17878,206,44,4820,2651,20.6,1928.4
4520841378,1,13,3,0,4,7,3,1,1,0,0,16055,6.8,17933,227,55,93,1195,22.7,1605.5,15,1,1,7,4,9,0,0,0,0,15962,6.8,16738,214,36,-93,-1195,21.4,1596.2
4520879335,0,13,4,0,5,10,5,0,0,0,0,16925,6.6,18087,233,64,-962,107,23.3,1692.5,17,3,1,10,5,16,1,1,0,0,17887,7,17980,213,44,962,-107,21.3,1788.7
4524882878,1,18,2,1,7,5,5,1,1,0,0,16496,7,18201,202,55,1744,1187,20.2,1649.6,15,5,0,5,7,5,0,0,0,0,14752,6.6,17014,209,36,-1744,-1187,20.9,1475.2
4518934441,0,16,5,1,3,9,1,0,0,0,0,14302,6.6,15878,211,51,-3025,-2906,21.1,1430.2,36,1,0,9,3,9,2,1,1,0,17327,7.2,18784,212,64,3025,2906,21.2,1732.7
4517917805,1,17,1,0,6,9,10,1,1,0,0,17217,7,18979,222,60,-315,-7,22.2,1721.7,22,2,1,9,6,11,0,0,0,0,17532,7,18986,218,52,315,7,21.8,1753.2
4453066386,0,16,2,0,2,8,2,1,0,1,0,14786,6.6,16676,233,50,-1340,-529,23.3,1478.6,16,4,1,8,2,6,1,1,0,0,16126,6.8,17205,205,37,1340,529,20.5,1612.6
4522541186,1,165,3,1,11,8,8,1,1,0,1,19556,7,18352,229,41,2585,1759,22.9,1955.6,14,1,0,8,11,9,0,0,0,0,16971,6.6,16593,169,63,-2585,-1759,16.9,1697.1
4500486602,0,28,2,0,3,3,2,0,0,0,0,15134,7,18028,214,54,-168,267,21.4,1513.4,17,2,1,3,3,4,1,1,0,0,15302,7,17761,214,61,168,-267,21.4,1530.2
4452390949,1,11,3,1,9,4,11,1,1,0,0,17003,6.8,17799,188,58,2247,1668,18.8,1700.3,14,0,0,4,9,3,0,0,0,0,14756,6.4,16131,189,48,-2247,-1668,18.9,1475.6
4450459916,0,14,3,1,6,12,7,1,1,0,0,16043,7,17409,220,51,-3089,-2946,22,1604.3,20,4,0,12,6,12,0,0,0,0,19132,7.6,20355,235,50,3089,2946,23.5,1913.2
4465074882,1,19,2,1,6,3,5,0,0,0,0,17837,7.2,19440,238,76,2970,2037,23.8,1783.7,50,4,0,3,6,4,0,0,0,0,14867,7,17403,217,52,-2970,-2037,21.7,1486.7
4522845066,0,21,5,1,5,4,5,0,0,0,0,16022,7,17853,219,60,511,-678,21.9,1602.2,78,1,0,4,5,9,1,0,1,0,15511,7,18531,242,42,-511,678,24.2,1551.1
4506217760,1,14,3,1,11,6,14,1,1,0,0,18056,6.8,17829,195,54,250,287,19.5,1805.6,268,2,0,6,11,7,1,0,1,1,17806,7,17542,210,59,-250,-287,21,1780.6
4484417350,0,15,1,0,2,8,3,0,0,0,0,14433,6.6,16813,202,64,-3215,-1656,20.2,1443.3,21,3,1,8,2,7,1,0,1,0,17648,7.2,18469,243,43,3215,1656,24.3,1764.8
4524611648,1,15,3,1,7,7,9,0,0,0,0,16946,6.8,18077,212,45,1482,1055,21.2,1694.6,17,3,0,7,7,7,1,1,0,0,15464,7,17022,161,48,-1482,-1055,16.1,1546.4
4439348607,0,19,5,0,7,11,11,1,1,0,0,16187,6.4,16701,216,30,-2377,-2355,21.6,1618.7,20,0,1,11,7,14,0,0,0,0,18564,7,19056,206,67,2377,2355,20.6,1856.4
4483760431,1,11,1,0,8,5,10,2,1,1,0,17823,7.4,19752,215,64,1014,950,21.5,1782.3,9,1,1,5,8,5,0,0,0,0,16809,7,18802,219,75,-1014,-950,21.9,1680.9
4513003533,0,22,3,0,9,10,14,1,1,0,0,16749,6.4,16227,166,48,-2419,-3313,16.6,1674.9,19,1,1,10,9,13,0,0,0,0,19168,7.4,19540,240,39,2419,3313,24,1916.8
4485980330,1,15,6,0,2,6,2,0,0,0,0,16241,7.2,18365,236,57,250,942,23.6,1624.1,38,0,1,6,2,8,1,1,0,0,15991,6.8,17423,196,56,-250,-942,19.6,1599.1
4524532805,0,10,1,0,6,6,5,1,1,0,0,16490,7,19578,214,68,-392,462,21.4,1649,16,1,1,6,6,8,0,0,0,0,16882,7.2,19116,232,56,392,-462,23.2,1688.2
4511502291,1,13,4,0,7,8,6,1,0,1,0,16464,6.6,17075,209,52,166,395,20.9,1646.4,16,1,1,8,7,12,1,1,0,0,16298,6.6,16680,167,40,-166,-395,16.7,1629.8
4499810008,0,12,4,0,6,6,10,0,0,0,0,15241,6.6,16491,190,36,-1137,-1402,19,1524.1,17,1,1,6,6,6,2,1,1,0,16378,6.8,17893,224,45,1137,1402,22.4,1637.8
4456960285,1,19,5,0,10,8,10,1,1,0,0,17251,6.8,17415,217,46,-733,-541,21.7,1725.1,17,3,1,8,10,13,0,0,0,0,17984,6.8,17956,234,39,733,541,23.4,1798.4
4524361228,0,15,3,0,1,7,2,0,0,0,0,13519,6.4,15833,188,53,-4115,-2985,18.8,1351.9,18,2,1,7,1,9,1,1,0,0,17634,7,18818,251,47,4115,2985,25.1,1763.4
4468797183,1,10,2,0,7,7,6,2,1,1,2,19453,7,18832,239,64,3773,1957,23.9,1945.3,13,0,1,7,7,6,0,0,0,0,15680,6.6,16875,170,52,-3773,-1957,17,1568
4524026578,0,14,1,0,4,5,4,0,0,0,0,15482,7.2,18715,237,47,-1335,-172,23.7,1548.2,39,2,1,5,4,5,2,1,1,0,16817,7.2,18887,228,55,1335,172,22.8,1681.7
4512312350,1,16,2,1,7,4,4,1,1,0,0,17107,7.2,19237,218,68,2169,2453,21.8,1710.7,30,1,0,4,7,4,0,0,0,0,14938,6.6,16784,212,40,-2169,-2453,21.2,1493.8
4447452177,0,14,4,1,3,3,1,0,0,0,0,14486,7,18218,200,63,-648,728,20,1448.6,19,3,0,3,3,3,1,1,0,0,15134,7,17490,208,56,648,-728,20.8,1513.4
4514358264,1,15,7,0,4,2,3,1,1,0,0,15444,7,17833,236,53,1019,708,23.6,1544.4,17,1,1,2,4,0,0,0,0,0,14425,6.6,17125,229,44,-1019,-708,22.9,1442.5
4407738489,0,50,1,1,6,12,4,0,0,0,0,15809,6.8,17592,198,30,-3854,-1813,19.8,1580.9,14,1,0,12,6,15,0,0,0,0,19663,7.2,19405,238,39,3854,1813,23.8,1966.3
4520529176,1,17,3,1,9,5,10,2,1,1,0,18283,7.2,18731,226,59,2684,1191,22.6,1828.3,41,3,0,5,9,4,0,0,0,0,15599,7,17540,211,37,-2684,-1191,21.1,1559.9
4458640668,0,19,0,0,5,10,2,0,0,0,0,16451,7,18416,220,59,-977,143,22,1645.1,15,1,1,10,5,8,0,0,0,0,17428,6.8,18273,189,53,977,-143,18.9,1742.8
4477445574,1,17,4,1,4,2,3,0,0,0,0,16267,6.8,18319,246,52,1362,699,24.6,1626.7,16,1,0,2,4,4,2,1,1,0,14905,7,17620,228,64,-1362,-699,22.8,1490.5
4443008526,0,19,4,1,8,8,2,0,0,0,0,16249,6.8,17245,189,41,-1276,-648,18.9,1624.9,16,0,0,8,8,11,0,0,0,0,17525,7,17893,193,42,1276,648,19.3,1752.5
4477502000,1,60,4,1,6,7,7,1,0,1,0,17247,7,18845,233,65,915,1710,23.3,1724.7,16,3,0,7,6,9,0,0,0,0,16332,7,17135,214,36,-915,-1710,21.4,1633.2
4506376932,0,23,3,0,4,2,5,0,0,0,0,15707,6.8,17968,243,55,428,687,24.3,1570.7,17,5,1,2,4,4,1,1,0,0,15279,6.8,17281,247,42,-428,-687,24.7,1527.9
4478461160,1,14,2,1,9,0,8,0,0,0,0,17086,7.2,19170,221,49,3655,2743,22.1,1708.6,37,2,0,0,9,0,1,1,0,0,13431,6.4,16427,198,60,-3655,-2743,19.8,1343.1
4515697055,0,13,7,1,7,6,7,0,0,0,0,16443,7,18461,193,52,-1706,-1027,19.3,1644.3,16,1,0,6,7,6,0,0,0,0,18149,7.2,19488,247,68,1706,1027,24.7,1814.9
4524478226,1,15,2,0,12,10,20,0,0,0,0,17961,6.8,17984,172,32,478,-124,17.2,1796.1,61,1,1,10,12,17,1,1,0,0,17483,6.8,18108,159,75,-478,124,15.9,1748.3
4495005465,0,11,2,0,6,8,7,0,0,0,0,16924,6.8,17938,233,47,-465,-436,23.3,1692.4,81,1,1,8,6,10,0,0,0,0,17389,7.2,18374,214,42,465,436,21.4,1738.9
4501131347,1,44,5,1,14,12,14,1,1,0,0,19418,6.8,18520,204,49,1698,2237,20.4,1941.8,21,5,0,12,14,11,1,0,1,0,17720,6.6,16283,167,51,-1698,-2237,16.7,1772
4518159499,0,38,2,0,6,8,8,0,0,0,0,16917,7.2,18964,212,62,-1013,-36,21.2,1691.7,12,1,1,8,6,6,1,1,0,0,17930,7,19000,260,56,1013,36,26,1793
4500439445,1,18,2,1,4,5,3,0,0,0,0,15846,7,18388,214,58,-330,-466,21.4,1584.6,15,3,0,5,4,5,1,1,0,0,16176,7.2,18854,236,52,330,466,23.6,1617.6
4523041612,0,17,2,0,5,4,4,0,0,0,0,16891,7.4,19197,207,79,1060,1554,20.7,1689.1,69,3,1,4,5,4,1,1,0,0,15831,6.8,17643,211,60,-1060,-1554,21.1,1583.1
4521846073,1,22,2,1,6,5,7,1,0,1,0,16937,7,18194,221,43,592,242,22.1,1693.7,14,3,0,5,6,4,1,1,0,0,16345,7.2,17952,215,67,-592,-242,21.5,1634.5
4520688318,0,54,4,0,11,6,22,1,0,1,0,18640,7,18015,226,48,1931,1200,22.6,1864,13,2,1,6,11,10,1,1,0,0,16709,6.6,16815,232,62,-1931,-1200,23.2,1670.9
4524780505,1,18,3,1,6,2,6,1,1,0,0,16868,6.8,18060,245,52,1982,990,24.5,1686.8,16,2,0,2,6,6,0,0,0,0,14886,6.8,17070,227,60,-1982,-990,22.7,1488.6
4519427485,0,24,4,1,6,4,8,0,0,0,0,16505,6.8,17567,205,52,805,149,20.5,1650.5,13,8,0,4,6,4,1,1,0,0,15700,7,17418,256,44,-805,-149,25.6,1570
4480448606,1,15,3,0,10,7,8,1,0,1,0,19289,7.6,19633,240,63,2330,2319,24,1928.9,52,2,1,7,10,9,0,0,0,0,16959,7,17314,200,39,-2330,-2319,20,1695.9
4524317634,0,17,3,1,1,4,1,0,0,0,0,14064,6.6,16539,220,37,-1765,-2344,22,1406.4,17,4,0,4,1,2,1,1,0,0,15829,6.8,18883,244,62,1765,2344,24.4,1582.9
4521063765,1,14,4,0,3,3,4,1,1,0,0,15138,7,18807,194,66,-105,1086,19.4,1513.8,16,2,1,3,3,3,0,0,0,0,15243,7,17721,235,55,105,-1086,23.5,1524.3
4508697399,0,13,1,1,1,2,1,0,0,0,0,15094,6.8,18255,246,51,-92,-244,24.6,1509.4,12,0,0,2,1,3,1,1,0,0,15186,6.8,18499,226,64,92,244,22.6,1518.6
4446243794,1,16,4,0,1,5,1,2,1,1,0,14942,7,17727,210,83,-1215,-756,21,1494.2,21,3,1,5,1,7,0,0,0,0,16157,7,18483,233,52,1215,756,23.3,1615.7
4494950726,0,69,2,1,5,11,5,1,1,0,0,15633,6.8,17179,193,54,-2947,-2189,19.3,1563.3,17,1,0,11,5,13,0,0,0,0,18580,7.2,19368,224,43,2947,2189,22.4,1858
4473257949,1,18,2,1,5,3,7,2,1,1,0,15427,6.8,17667,217,47,134,-144,21.7,1542.7,19,4,0,3,5,2,0,0,0,0,15293,7,17811,235,51,-134,144,23.5,1529.3
4509810925,0,16,1,0,6,6,7,1,1,0,0,15703,6.8,16893,191,40,-951,-1116,19.1,1570.3,12,3,1,6,6,8,0,0,0,0,16654,7.2,18009,221,51,951,1116,22.1,1665.4
4523527699,1,108,5,1,6,5,8,0,0,0,0,16620,7,17711,238,37,361,-672,23.8,1662,17,0,0,5,6,5,0,0,0,0,16259,7,18383,223,54,-361,672,22.3,1625.9
4454501300,0,15,1,1,9,6,5,0,0,0,0,16852,6.6,17417,210,38,348,-1004,21,1685.2,15,5,0,6,9,6,1,1,0,0,16504,7,18421,216,60,-348,1004,21.6,1650.4
4522356055,1,19,2,0,6,5,5,1,1,0,0,15926,6.8,17186,209,44,905,1369,20.9,1592.6,15,2,1,5,6,10,0,0,0,0,15021,6.4,15817,180,40,-905,-1369,18,1502.1
4516589560,0,14,1,1,6,8,6,0,0,0,0,16936,7.2,18023,219,64,-424,-630,21.9,1693.6,14,2,0,8,6,10,2,1,1,0,17360,7,18653,230,48,424,630,23,1736
4505605320,1,15,4,1,10,4,13,1,1,0,0,17917,7.2,18904,212,37,3058,1325,21.2,1791.7,37,1,0,4,10,2,1,0,1,0,14859,6.8,17579,222,52,-3058,-1325,22.2,1485.9
4470336918,0,16,1,1,7,8,11,1,1,0,0,17558,6.8,17445,241,48,-105,-1401,24.1,1755.8,18,4,0,8,7,9,1,0,1,0,17663,6.8,18846,232,50,105,1401,23.2,1766.3
4524960407,1,22,0,1,4,7,4,1,0,1,1,17104,6.6,17075,224,61,-669,-502,22.4,1710.4,17,4,0,7,4,8,1,1,0,0,17773,6.8,17577,209,46,669,502,20.9,1777.3
4522654087,0,12,0,0,3,8,3,0,0,0,0,15149,6.8,17143,205,51,-1876,-2659,20.5,1514.9,13,2,1,8,3,4,1,1,0,0,17025,7.4,19802,211,76,1876,2659,21.1,1702.5
4492820318,1,51,3,0,10,5,16,1,1,0,1,17535,6.4,15420,173,40,1436,-1544,17.3,1753.5,14,2,1,5,10,4,0,0,0,0,16099,6.8,16964,207,66,-1436,1544,20.7,1609.9
4523758251,0,15,1,0,5,7,8,1,1,0,0,16112,6.4,16747,215,52,-1031,-760,21.5,1611.2,17,1,1,7,5,10,0,0,0,0,17143,6.8,17507,211,56,1031,760,21.1,1714.3
4519483383,1,9,3,1,6,7,6,1,0,1,0,16317,7,18679,204,71,-713,103,20.4,1631.7,84,4,0,7,6,5,1,1,0,0,17030,6.8,18576,212,52,713,-103,21.2,1703
4522558200,0,39,1,1,7,4,6,0,0,0,0,15885,7.2,19056,207,52,125,2058,20.7,1588.5,22,5,0,4,7,4,0,0,0,0,15760,6.8,16998,224,47,-125,-2058,22.4,1576
4520868488,1,15,3,1,9,3,11,0,0,0,0,17592,7,18664,220,41,1411,766,22,1759.2,11,1,0,3,9,4,1,1,0,0,16181,7,17898,215,62,-1411,-766,21.5,1618.1
4482355547,0,23,1,1,8,10,8,1,1,0,0,17321,7,18683,205,59,-78,-155,20.5,1732.1,13,2,0,10,8,7,1,0,1,0,17399,7.4,18838,207,40,78,155,20.7,1739.9
4457621044,1,47,3,1,2,1,3,1,1,0,0,15420,7,18204,230,65,661,139,23,1542,14,2,0,1,2,2,0,0,0,0,14759,6.6,18065,245,56,-661,-139,24.5,1475.9
4523957266,0,19,2,0,4,7,2,0,0,0,0,15649,7.2,18614,234,66,-1975,-1115,23.4,1564.9,24,4,1,7,4,7,1,1,0,0,17624,7.2,19729,243,55,1975,1115,24.3,1762.4
4500738372,1,20,3,0,6,3,5,0,0,0,0,16737,7.4,19857,243,64,1204,2004,24.3,1673.7,16,4,1,3,6,2,1,1,0,0,15533,6.8,17853,250,48,-1204,-2004,25,1553.3
4494262239,0,14,0,0,3,4,6,0,0,0,0,15929,6.8,17529,226,40,-394,-1635,22.6,1592.9,14,1,1,4,3,4,1,0,1,0,16323,7,19164,237,64,394,1635,23.7,1632.3
4487705166,1,59,2,0,3,6,6,1,1,0,0,15442,6.8,17518,238,51,-1090,-1499,23.8,1544.2,11,17,1,6,3,6,0,0,0,0,16532,6.8,19017,233,56,1090,1499,23.3,1653.2
4524530241,0,49,0,1,4,4,4,0,0,0,0,15046,6.6,16504,178,48,-557,-832,17.8,1504.6,13,5,0,4,4,6,0,0,0,0,15603,6.6,17336,217,52,557,832,21.7,1560.3
4522459951,1,15,5,1,9,4,12,1,1,0,0,17190,6.6,17783,210,41,1847,1084,21,1719,14,2,0,4,9,5,1,0,1,0,15343,6.8,16699,200,40,-1847,-1084,20,1534.3
4520610441,0,41,2,1,6,7,8,0,0,0,0,15756,6.6,16210,204,49,-1966,-3189,20.4,1575.6,18,4,0,7,6,6,0,0,0,0,17722,7.4,19399,242,60,1966,3189,24.2,1772.2
4524900733,1,16,1,0,6,9,3,1,1,0,0,15704,6.6,17114,199,52,-1332,-2004,19.9,1570.4,14,6,1,9,6,10,0,0,0,0,17036,7.2,19118,217,40,1332,2004,21.7,1703.6
4524841427,0,16,2,1,9,8,12,1,0,1,0,16649,6.2,15616,166,36,-1152,-2193,16.6,1664.9,19,2,0,8,9,8,1,1,0,0,17801,6.8,17809,208,48,1152,2193,20.8,1780.1
4500291945,1,16,0,1,7,3,10,1,1,0,0,17546,6.8,17209,228,47,1493,1167,22.8,1754.6,10,2,0,3,7,4,1,0,1,1,16053,6.4,16042,193,51,-1493,-1167,19.3,1605.3
4501013460,0,27,0,0,6,10,4,1,0,1,0,16171,7,17902,202,54,-1682,-71,20.2,1617.1,14,2,1,10,6,8,1,1,0,0,17853,7,17973,226,52,1682,71,22.6,1785.3
4481739224,1,19,5,0,6,6,9,0,0,0,0,16740,7,19237,238,54,218,1085,23.8,1674,18,4,1,6,6,8,1,1,0,0,16522,7,18152,229,54,-218,-1085,22.9,1652.2
4524235691,0,91,4,1,7,6,12,0,0,0,0,17222,7,18157,227,48,808,-236,22.7,1722.2,13,3,0,6,7,3,1,1,0,0,16414,7,18393,250,53,-808,236,25,1641.4
4525228858,1,14,3,1,13,1,10,1,1,0,1,20295,7.2,19531,258,56,6907,4512,25.8,2029.5,15,2,0,1,13,1,0,0,0,0,13388,6.2,15019,178,54,-6907,-4512,17.8,1338.8
4521830295,0,16,2,0,9,18,9,0,0,0,0,16331,6.4,14886,162,31,-3966,-2999,16.2,1633.1,18,2,1,18,9,16,1,0,1,0,20297,6.8,17885,169,38,3966,2999,16.9,2029.7
4522283833,1,13,1,0,4,5,7,0,0,0,0,15921,7,18190,217,48,-594,-353,21.7,1592.1,14,1,1,5,4,7,2,1,1,0,16515,7.2,18543,235,48,594,353,23.5,1651.5
4460355612,0,33,1,0,10,7,11,1,0,1,1,19186,7.2,18375,183,51,1377,795,18.3,1918.6,14,2,1,7,10,8,1,1,0,0,17809,7,17580,201,52,-1377,-795,20.1,1780.9
4516698364,1,15,2,0,5,4,7,0,0,0,0,15936,7,18030,205,43,554,-702,20.5,1593.6,28,0,1,4,5,4,0,0,0,0,15382,7,18732,179,68,-554,702,17.9,1538.2
4512192023,0,18,4,0,4,7,5,0,0,0,0,15198,6.8,17177,219,38,-2876,-2715,21.9,1519.8,10,4,1,7,4,9,1,0,1,0,18074,7.2,19892,222,92,2876,2715,22.2,1807.4
4507824198,1,17,1,1,7,2,5,1,0,1,0,16649,7.4,19322,226,47,1256,-295,22.6,1664.9,16,6,0,2,7,1,1,1,0,0,15393,7.4,19617,268,63,-1256,295,26.8,1539.3
4489456327,0,42,3,0,8,7,13,1,1,0,0,17909,6.4,16512,165,39,1340,-207,16.5,1790.9,19,4,1,7,8,10,0,0,0,0,16569,6.6,16719,201,32,-1340,207,20.1,1656.9
4508436860,1,40,2,1,10,2,14,1,1,0,0,17618,7,18556,203,36,4373,4286,20.3,1761.8,13,4,0,2,10,3,0,0,0,0,13245,6,14270,184,24,-4373,-4286,18.4,1324.5
4522648784,0,18,3,0,4,7,2,0,0,0,0,15046,6.6,17140,208,48,-1208,-614,20.8,1504.6,37,4,1,7,4,5,1,1,0,0,16254,7,17754,227,44,1208,614,22.7,1625.4
4451008750,1,24,2,1,6,5,6,0,0,0,0,15871,6.6,17106,195,45,-245,-278,19.5,1587.1,14,2,0,5,6,6,1,1,0,0,16116,7,17384,221,45,245,278,22.1,1611.6
4473660797,0,15,0,0,10,9,13,2,1,1,0,17145,7,17904,192,45,-1464,-454,19.2,1714.5,15,3,1,9,10,5,0,0,0,0,18609,7.2,18358,226,46,1464,454,22.6,1860.9
4517825338,1,16,4,1,7,2,6,0,0,0,0,17423,7.4,19973,248,55,2822,2207,24.8,1742.3,24,3,0,2,7,2,1,1,0,0,14601,7,17766,219,64,-2822,-2207,21.9,1460.1
4456309511,0,15,1,1,8,8,7,1,0,1,1,17676,7,18151,206,32,393,-215,20.6,1767.6,16,1,0,8,8,9,1,1,0,0,17283,7,18366,223,46,-393,215,22.3,1728.3
4516557839,1,19,2,0,7,8,8,0,0,0,0,16992,7,18385,219,44,-371,-172,21.9,1699.2,30,3,1,8,7,7,1,1,0,0,17363,7.2,18557,225,65,371,172,22.5,1736.3
4522021441,0,12,2,0,1,10,0,0,0,0,0,13410,6.4,16059,210,52,-5025,-2610,21,1341,19,4,1,10,1,16,1,1,0,0,18435,7.2,18669,228,58,5025,2610,22.8,1843.5
4519886299,1,16,4,1,8,4,10,2,1,1,1,18678,7,18538,231,56,3999,2223,23.1,1867.8,13,1,0,4,8,5,0,0,0,0,14679,6.6,16315,193,42,-3999,-2223,19.3,1467.9
4470465305,0,22,1,0,5,12,12,0,0,0,0,16220,7,17906,222,66,-4157,-1724,22.2,1622,15,1,1,12,5,24,1,1,0,0,20377,7.4,19630,257,52,4157,1724,25.7,2037.7
4491168583,1,51,4,0,7,5,14,1,1,0,0,17075,7,18159,230,52,462,579,23,1707.5,17,4,1,5,7,6,0,0,0,0,16613,6.6,17580,224,51,-462,-579,22.4,1661.3
4523482714,0,31,0,0,5,12,2,0,0,0,0,14930,6,15593,169,56,-5298,-4670,16.9,1493,11,1,1,12,5,14,1,1,0,0,20228,7.4,20263,242,52,5298,4670,24.2,2022.8
4521124599,1,14,3,1,6,4,9,2,1,1,0,16972,7.4,19577,218,55,752,344,21.8,1697.2,15,1,0,4,6,3,0,0,0,0,16220,7.2,19233,247,68,-752,-344,24.7,1622
4520785581,0,12,2,0,7,8,7,0,0,0,0,16304,6.8,17825,201,51,-28,-63,20.1,1630.4,14,1,1,8,7,4,0,0,0,0,16332,6.8,17888,209,41,28,63,20.9,1633.2
4469793505,1,15,2,0,6,3,9,0,0,0,0,16568,7.2,18645,197,52,1188,2039,19.7,1656.8,20,2,1,3,6,4,2,1,1,0,15380,6.8,16606,207,52,-1188,-2039,20.7,1538
4501782812,0,16,4,0,5,3,5,0,0,0,0,15499,7,17516,225,47,-81,-1,22.5,1549.9,17,3,1,3,5,3,1,1,0,0,15580,6.8,17517,214,60,81,1,21.4,1558
4524882681,1,14,1,1,7,3,10,1,0,1,0,17326,7.2,18459,224,56,1639,-213,22.4,1732.6,17,2,0,3,7,3,1,1,0,0,15687,7,18672,248,68,-1639,213,24.8,1568.7
4501847669,0,14,2,0,6,10,5,0,0,0,0,15256,6.6,16464,189,28,-1555,-357,18.9,1525.6,17,2,1,10,6,12,1,1,0,0,16811,6.8,16821,182,45,1555,357,18.2,1681.1
4520333259,1,16,5,0,6,4,7,0,0,0,0,16619,7.2,18958,226,51,1552,1488,22.6,1661.9,31,4,1,4,6,5,0,0,0,0,15067,6.8,17470,213,52,-1552,-1488,21.3,1506.7
4511049704,0,14,4,0,4,5,4,0,0,0,0,16295,7.2,18278,261,36,41,-936,26.1,1629.5,56,2,1,5,4,5,1,1,0,0,16254,7.2,19214,234,64,-41,936,23.4,1625.4
4488805966,1,12,2,1,7,4,7,1,1,0,0,15680,6.6,17099,186,52,-259,-1115,18.6,1568,37,1,0,4,7,4,0,0,0,0,15939,7,18214,227,51,259,1115,22.7,1593.9
4452201690,0,15,1,1,7,7,8,0,0,0,0,16432,6.8,16967,191,36,367,-1025,19.1,1643.2,32,2,0,7,7,7,1,1,0,0,16065,7,17992,212,47,-367,1025,21.2,1606.5
4523749055,1,15,3,0,10,6,9,2,1,1,2,19197,7.2,18449,219,53,2941,1850,21.9,1919.7,15,6,1,6,10,6,0,0,0,0,16256,6.6,16599,192,52,-2941,-1850,19.2,1625.6
4525132026,0,36,1,0,3,8,5,1,1,0,0,15028,6.8,17228,232,40,-2254,-379,23.2,1502.8,18,3,1,8,3,8,0,0,0,0,17282,7,17607,232,48,2254,379,23.2,1728.2
4520672989,1,15,2,1,10,7,8,1,1,0,0,18468,7.2,18822,221,51,1142,283,22.1,1846.8,18,3,0,7,10,6,0,0,0,0,17326,7.2,18539,252,40,-1142,-283,25.2,1732.6
4496837103,0,13,2,0,2,7,3,1,0,1,0,14624,6.8,16881,210,57,-2089,537,21,1462.4,39,5,1,7,2,10,0,0,0,0,16713,6.6,16344,215,38,2089,-537,21.5,1671.3
4447744489,1,21,1,1,9,5,10,0,0,0,0,18280,7,18115,229,35,4051,1394,22.9,1828,19,5,0,5,9,3,1,1,0,0,14229,6.6,16721,211,36,-4051,-1394,21.1,1422.9
4438388290,0,17,2,0,6,7,4,1,0,1,0,16331,7.2,17920,231,49,-226,-221,23.1,1633.1,37,3,1,7,6,7,0,0,0,0,16557,7,18141,226,54,226,221,22.6,1655.7
4495628923,1,17,5,0,5,9,7,0,0,0,0,16103,6.6,17019,193,48,-2419,-1437,19.3,1610.3,50,5,1,9,5,14,1,0,1,0,18522,7,18456,246,40,2419,1437,24.6,1852.2
4495074549,0,16,4,1,3,6,3,0,0,0,0,14910,6.6,15466,195,36,-821,-2540,19.5,1491,44,3,0,6,3,4,1,1,0,0,15731,6.8,18006,206,67,821,2540,20.6,1573.1
4423079773,1,16,4,1,6,4,8,2,1,1,0,16832,7.2,18675,221,65,1624,1008,22.1,1683.2,17,1,0,4,6,5,0,0,0,0,15208,7,17667,238,33,-1624,-1008,23.8,1520.8
4481631636,0,19,4,0,2,8,1,0,0,0,0,14208,7,17036,194,64,-4891,-2335,19.4,1420.8,20,1,1,8,2,8,1,0,1,1,19099,7.2,19371,266,40,4891,2335,26.6,1909.9
4496068567,1,13,2,1,9,5,6,1,0,1,0,17076,7.2,18945,194,54,834,1853,19.4,1707.6,16,0,0,5,9,2,0,0,0,0,16242,6.6,17092,238,36,-834,-1853,23.8,1624.2
4501386832,0,19,1,1,8,2,11,0,0,0,0,17526,6.8,17824,222,63,2761,680,22.2,1752.6,13,3,0,2,8,2,1,1,0,0,14765,6.8,17144,216,64,-2761,-680,21.6,1476.5
4503581851,1,20,2,1,7,4,6,0,0,0,0,16745,6.8,17283,210,35,2150,1104,21,1674.5,14,4,0,4,7,3,0,0,0,0,14595,6.6,16179,187,50,-2150,-1104,18.7,1459.5
4522201208,0,35,1,0,5,3,5,1,0,1,1,17854,7.4,20383,230,56,2323,2120,23,1785.4,13,1,1,3,5,2,0,0,0,0,15531,7,18263,219,52,-2323,-2120,21.9,1553.1
4487682437,1,15,2,0,4,8,4,1,0,1,0,15658,6.6,17351,222,42,-1624,-2019,22.2,1565.8,16,1,1,8,4,8,1,1,0,0,17282,7.4,19370,207,61,1624,2019,20.7,1728.2
4515342785,0,15,2,1,6,5,4,1,1,0,0,15698,7,17468,206,59,-1143,-859,20.6,1569.8,15,1,0,5,6,3,1,0,1,0,16841,7,18327,259,50,1143,859,25.9,1684.1
4522601475,1,8,0,1,6,5,6,1,0,1,0,15760,7.2,18719,167,72,-2072,412,16.7,1576,16,2,0,5,6,2,1,1,0,1,17832,7,18307,268,51,2072,-412,26.8,1783.2
4519595865,0,16,5,0,3,8,4,1,0,1,0,14506,6.8,16989,206,52,-2520,-1932,20.6,1450.6,16,1,1,8,3,7,1,1,0,0,17026,7.2,18921,221,56,2520,1932,22.1,1702.6
4497765026,1,10,4,0,2,3,1,0,0,0,0,15568,7,18302,245,48,542,1212,24.5,1556.8,16,1,1,3,2,4,1,1,0,0,15026,6.6,17090,209,62,-542,-1212,20.9,1502.6
4495304851,0,15,1,0,8,6,3,0,0,0,0,16678,7,18875,216,64,1079,1586,21.6,1667.8,15,5,1,6,8,3,1,1,0,0,15599,6.8,17289,220,32,-1079,-1586,22,1559.9
4524881998,1,32,2,1,7,5,7,2,1,1,0,17204,7.4,18986,240,60,316,10,24,1720.4,36,1,0,5,7,4,0,0,0,0,16888,7,18976,236,48,-316,-10,23.6,1688.8
4504908173,0,11,1,0,5,14,3,0,0,0,0,15322,6.4,15807,210,56,-4024,-2373,21,1532.2,18,2,1,14,5,17,1,1,0,0,19346,6.8,18180,203,47,4024,2373,20.3,1934.6
4518759823,1,37,3,1,12,5,15,1,1,0,0,19141,7.6,20647,192,60,4294,4438,19.2,1914.1,15,2,0,5,12,3,0,0,0,0,14847,6.4,16209,210,36,-4294,-4438,21,1484.7
4520894516,0,38,4,1,5,7,4,0,0,0,0,16562,7.2,18781,210,64,44,170,21,1656.2,21,1,0,7,5,8,1,1,0,0,16518,7,18611,245,36,-44,-170,24.5,1651.8
4490315006,1,21,3,0,9,4,7,1,1,0,0,17951,6.8,18031,234,44,3432,2317,23.4,1795.1,16,1,1,4,9,9,0,0,0,0,14519,6.4,15714,183,45,-3432,-2317,18.3,1451.9
4506495968,0,8,2,0,7,11,6,1,0,1,0,16998,6.6,17282,207,55,-1343,-591,20.7,1699.8,18,3,1,11,7,15,1,1,0,0,18341,6.8,17873,191,40,1343,591,19.1,1834.1
4521403114,1,15,2,1,7,8,8,1,1,0,0,16142,6.8,17610,197,62,-563,-812,19.7,1614.2,24,4,0,8,7,12,0,0,0,0,16705,7,18422,207,48,563,812,20.7,1670.5
4464777980,0,19,2,0,5,5,7,1,1,0,0,15051,6.6,16743,188,35,60,323,18.8,1505.1,11,2,1,5,5,4,0,0,0,0,14991,6.8,16420,206,44,-60,-323,20.6,1499.1
4521688394,1,15,4,0,4,4,5,0,0,0,0,16333,7.2,19527,237,65,60,-341,23.7,1633.3,23,5,1,4,4,3,1,1,0,0,16273,7.6,19868,252,80,-60,341,25.2,1627.3
4523251665,0,48,3,0,3,6,6,0,0,0,0,14986,6.8,17222,208,46,-1501,-1478,20.8,1498.6,18,3,1,6,3,4,0,0,0,0,16487,7.2,18700,220,49,1501,1478,22,1648.7
4515233268,1,14,4,1,7,7,7,2,1,1,0,17381,7.2,20017,221,76,1542,2179,22.1,1738.1,17,2,0,7,7,4,0,0,0,0,15839,7,17838,204,48,-1542,-2179,20.4,1583.9
4513442931,0,40,4,1,7,5,9,0,0,0,0,17003,6.6,18007,214,40,1331,1287,21.4,1700.3,16,1,0,5,7,8,0,0,0,0,15672,6.8,16720,190,52,-1331,-1287,19,1567.2
4483621634,1,19,3,0,6,7,4,0,0,0,0,16039,7,17942,195,49,-665,-571,19.5,1603.9,16,3,1,7,6,5,1,1,0,0,16704,7,18513,231,52,665,571,23.1,1670.4
4463059486,0,16,3,0,4,12,5,1,1,0,0,15380,6.6,15984,226,43,-4864,-2818,22.6,1538,17,2,1,12,4,17,1,0,1,2,20244,7.2,18802,231,36,4864,2818,23.1,2024.4
4497520104,1,141,2,0,6,6,6,0,0,0,0,16830,7,18944,226,51,708,1208,22.6,1683,18,2,1,6,6,4,2,1,1,0,16122,6.8,17736,204,54,-708,-1208,20.4,1612.2
4520650445,0,15,6,0,7,5,12,1,0,1,0,16605,6.6,16894,220,39,2046,584,22,1660.5,20,5,1,5,7,9,1,1,0,0,14559,6.6,16310,175,44,-2046,-584,17.5,1455.9
4483310485,1,19,2,0,2,1,3,1,1,0,0,14909,7,18031,245,52,410,720,24.5,1490.9,14,3,1,1,2,1,0,0,0,0,14499,6.8,17311,237,52,-410,-720,23.7,1449.9
4420437374,0,17,2,1,4,3,3,0,0,0,0,14742,6.8,17515,203,40,-541,-1094,20.3,1474.2,17,3,0,3,4,5,2,1,1,0,15283,7.2,18609,230,60,541,1094,23,1528.3
4514522984,1,14,3,0,0,5,0,0,0,0,0,12939,6.4,15958,201,32,-4578,-3673,20.1,1293.9,19,2,1,5,0,5,1,1,0,0,17517,7.4,19631,259,79,4578,3673,25.9,1751.7
4465091109,0,13,0,0,3,8,1,0,0,0,0,14440,7,17275,194,60,-3132,-1630,19.4,1444,17,2,1,8,3,6,1,1,0,0,17572,7,18905,220,50,3132,1630,22,1757.2
4520635728,1,14,3,1,6,8,5,1,0,1,0,16353,7,18367,214,56,-560,-46,21.4,1635.3,16,2,0,8,6,10,1,1,0,0,16913,7.4,18413,221,44,560,46,22.1,1691.3
4452001720,0,13,4,0,2,13,3,0,0,0,0,12798,5.4,12111,187,4,-8472,-8242,18.7,1279.8,16,1,1,13,2,16,1,1,0,1,21270,7.6,20353,224,64,8472,8242,22.4,2127
4511735384,1,16,1,1,9,3,8,2,1,1,0,18599,7.2,20735,216,76,3821,4288,21.6,1859.9,34,1,0,3,9,5,0,0,0,0,14778,6.8,16447,187,56,-3821,-4288,18.7,1477.8
4517686299,0,14,4,0,5,6,6,0,0,0,0,15698,6.6,17663,201,63,-687,-372,20.1,1569.8,23,3,1,6,5,8,1,1,0,0,16385,7,18035,230,43,687,372,23,1638.5
4524160140,1,14,1,0,6,7,6,0,0,0,0,15936,6.8,17755,192,46,-1477,-1018,19.2,1593.6,15,3,1,7,6,10,1,1,0,0,17413,7,18773,245,53,1477,1018,24.5,1741.3
4478918776,0,11,2,0,2,4,5,1,0,1,0,14613,6.8,17026,233,47,-2539,-943,23.3,1461.3,13,5,1,4,2,7,1,1,0,0,17152,7,17969,234,47,2539,943,23.4,1715.2
4452237596,1,15,2,1,3,2,2,0,0,0,0,15265,6.8,17859,224,52,446,263,22.4,1526.5,14,1,0,2,3,1,0,0,0,0,14819,6.6,17596,237,45,-446,-263,23.7,1481.9
4518368417,0,12,3,1,4,5,4,0,0,0,0,14705,6.6,16663,196,44,-2167,-2507,19.6,1470.5,17,1,0,5,4,6,1,1,0,0,16872,7.2,19170,240,65,2167,2507,24,1687.2
4506113510,1,16,1,1,10,3,12,1,1,0,0,18177,7,18965,219,50,3504,995,21.9,1817.7,16,3,0,3,10,4,0,0,0,0,14673,6.8,17970,214,46,-3504,-995,21.4,1467.3
4508403926,0,13,3,0,5,5,3,1,0,1,0,15226,6.6,17298,213,55,-521,-1275,21.3,1522.6,11,2,1,5,5,3,1,1,0,0,15747,7.2,18573,236,48,521,1275,23.6,1574.7
4524698589,1,80,3,1,7,2,7,1,1,0,0,17324,7.2,19349,216,48,3129,2922,21.6,1732.4,18,0,0,2,7,3,0,0,0,0,14195,6.8,16427,208,47,-3129,-2922,20.8,1419.5
4502937096,0,13,2,1,6,5,5,0,0,0,0,16051,7,17771,197,41,523,-1060,19.7,1605.1,15,5,0,5,6,4,1,1,0,0,15528,7.2,18831,226,54,-523,1060,22.6,1552.8
4487456685,1,16,3,0,8,5,10,0,0,0,0,17536,7.2,19665,247,47,910,1269,24.7,1753.6,16,5,1,5,8,6,1,1,0,0,16626,7,18396,226,68,-910,-1269,22.6,1662.6
4518125145,0,17,2,1,8,8,13,0,0,0,0,16934,6.4,16045,193,44,247,-775,19.3,1693.4,15,1,0,8,8,6,1,1,0,0,16687,6.6,16820,191,56,-247,775,19.1,1668.7
4521579265,1,17,1,0,3,4,4,0,0,0,0,15158,6.8,17197,236,47,-341,-1982,23.6,1515.8,18,3,1,4,3,5,2,1,1,0,15499,7,19179,219,56,341,1982,21.9,1549.9
4454573791,0,20,7,1,4,8,7,1,0,1,0,15228,6.8,16963,198,52,-2236,-2070,19.8,1522.8,20,5,0,8,4,8,1,1,0,0,17464,7.2,19033,227,48,2236,2070,22.7,1746.4
4521700370,1,15,3,1,10,4,7,0,0,0,0,17710,7,18758,205,56,3297,2983,20.5,1771,16,1,0,4,10,3,1,1,0,0,14413,6.4,15775,183,44,-3297,-2983,18.3,1441.3
4510866403,0,17,1,0,2,3,2,0,0,0,0,14971,7,18121,228,49,-682,-89,22.8,1497.1,18,4,1,3,2,5,1,1,0,0,15653,7.2,18210,252,49,682,89,25.2,1565.3
4463456988,1,16,2,0,7,3,4,2,1,1,0,17071,7.2,19347,234,64,1738,2447,23.4,1707.1,16,3,1,3,7,2,0,0,0,0,15333,6.8,16900,226,57,-1738,-2447,22.6,1533.3
4522684962,0,22,2,0,10,5,10,1,0,1,0,17835,7.2,18036,205,50,1923,437,20.5,1783.5,18,2,1,5,10,5,0,0,0,0,15912,6.8,17599,216,43,-1923,-437,21.6,1591.2
